11111111111111111111111
10010000000C00100000001
10000111110000010100001
1P0011F0000000000C10001
11111111111111111111111