1111111111111111111111111111111111
100000000000001C00001E000000000011
1010010100100001101001000000010101
1010010010101010001001000000010001
1P0000000C00C0000000000000000000C1
1111111111111111111111111111111111